Aaron	
Abby	(Abigail的简写)	
Abel	(Abelard的昵称)	
Abigail	希伯砀赣H很高d；自得的父H。	
Abigail	
Abraham	
Ada	英增光；快返模幻利。	
Adam	
Ada	(Adelaide的简写)	
Adela	德尊F的；雅的。	
Adelaide	德高F的；高FA的。	
Adelaide	
Adeline	
Adrian	
Afra	希伯m土	
Agatha	希D善良而美好的	
Agnes	希D，拉丁，高雅，	
Aidan	
Ailsa	
Aimee	
Alan	(常变形为Eilian,Allan,Ailin)	
Alberta	英高F@赫的。	
Albert	
Alexander	
Alexandra	
Alexia	希D椭	
Alexis	
Alex	(Alexander的昵称)	
Alfred	
Alice	希D尊F的，真#092;的	
Alice	
Alicia	
Alina	
Allison	
Alma	拉丁，英真情的、和善的、舞女。	
Althea	希D好A，t治者。	
Alva	拉丁白皙的。	
Alva	
Alyssa	
Amanda	拉丁值得鄣摹	
Amanda	
Amber	
Amelia	拉丁勤勉的，拥摹	
Amy	法最心鄣娜耍可鄣摹	
Amy	
Anastasia	希D再度振作起碇人，突睢	
Anastasia	(昵称Stacey)	
Andrea	希D有飧牛美而雅	
Andrea	
Andrew	
Andy	(Andrew的昵称)	
Angela	法天使；笮耪撸安琪骸	
Angela	
Angelia	
Angelina	
Angel	
Angus	
Anita	(Ann的西班牙写法)	
Ann	希伯雅的，仁慈的上帝。	
Anna	希伯雅	
Annabelle	希伯恚拉丁美的女子；可鄣模缓吞@可H的。	
Anna	
Anne	(同Ann)	
Annie	(Ann的昵称)	
Ann	(Hannah的英文形式)	
Anthony	
Antonia	拉丁，希Doo以，受尊崇的人。	
Apollo	
April	拉丁春天，大地初醒之r	
April	
Arabela	拉丁，日耳曼美的祭，易於求	
Ariel	
Arlene	
Arnold	
Arthur	
Ashley	
Astrid	丹神}的力量；星星的。	
Atalanta	希D跑得快的美少女。	
Athena	希D希D神中，聪明、及的女神，雅典的保o神。	
Audrey	法高F@赫的人。	
Audrey	
August	
Aurora	拉丁黎明女神	
Austin	
Aviva	(同Avivahc和Avivi)	
Barbara	希D外地淼娜耍l人；族人。	
Barbara	
Barbie	
Bblythe	英ono]的；快返摹	
Beata	
Beatrice	拉丁槿似砀；蚴谷丝返呐孩	
Beatrice	(同Beatrix)	
Becky	(Rebecca的昵称)	
Belinda	德、x大利像l蛇。有聪明又L鄣娜恕	
Bella	拉丁美的	
Bella	(Isabella的昵称)	
Belle	法美的；上帝的誓s；明高F。	
Benjamin	
Benson	
Ben	(所有Ben开头的英文名的昵称)	
Bernice	希Dе倮息淼娜恕	
Bertha	lD明、美或N的。	
Bert	
Beryl	希DG石，幸#092;。	
Bess	希伯砩系凼鞘募s。	
Bess	
Betsy	希伯砩系凼鞘募s。	
Bette	
Betty	希伯砩系凼鞘募s。	
Betty	(Elizabeth的昵称)	
Beulah	希伯硪呀Y婚的。	
Beverly	英	
Billy	
Bill	
Blake	
Blanche	lDo暇的；白N人的；白皙美的。	
Blanche	
Bobby	
Bob	
Bonnie	拉丁甜美、漂亮、雅而善良的人。	
Bonnie	
Brad	
Brandon	
Brant	
Breenda	w挑苷撸Γ缓隗	
Brenda	(Brandon及Brendan的女性形式)	
Brent	
Brian/Bryan	
Brianna	
Bridget	w或m眩力量	
Britney	
Brittany	
Brook	英傍溪而居之人。	
Brown	
Bruce	
Caleb	
Cameron	
Camille	拉丁好品性的高F女子。	
Camille	
Candance	拉丁崆椋坦#092;，的。	
Candice	拉丁崆椋坦#092;，的。	
Candice	
Candy	
Cara	x大利朋友；H鄣娜恕	
Carina	
Carlos	
Carl	
Carmen	
Carol	法g唱，耳g快的歌	
Caroline	lD勇、健和训摹	
Caroline	
Carol	
Carrie	(Carol及Caroline的昵称,同Kerry)	
Carry	
Cary	
Caspar	
Cassandra	
Cassie	(Catherine,Cassandra的昵称)	
Catherine	希D的人。	
Catherine	(Katherine的英文形式,同Katherine)	
Cathy	希D的人。	
Cathy	(Catherine的昵称,同Kathy)	
Cecilia	拉丁力朦V的人，失明的。	
Cecil	
Celeste	拉丁最幸福的人，天的。	
Charlene	(同Caroline,Charlotte)	
Charles	
Charlotte	法身w健女性化的。	
Charlotte	
Chelsea	
Cheney	
Cherry	法仁慈，像烟野慵t的人。	
Cherry	
Cheryl	法珍鄣娜耍男子h	
Cheryl	(Charlotte的另一形式,亦同Sheryl)	
Chloe	希D青春的，美的。	
Chloe	
Christian	
Christina	(同Christine)	
Christine	希D基督的追S者，T徒。	
Christine	
Christopher	
Christy	(Christine的简写)	
Chris	(Christine,Kristine的简写,同Kris)	
Chris	(Christian,Christopher的昵称)	
Cindy	(Cinderella,Cynthia,Lucinda的昵称)	
Claire	拉丁N的；明亮的；明的。	
Claire/Clair	
Clara	拉丁明亮的；明的。	
Clark	
Claudia	
Clementine	拉丁厝崆胰蚀鹊娜恕	
Clement	
Cliff	
Cloris	
Cody	
Cole	
Colin	
Connie	(Constance的昵称)	
Constance	拉丁远ㄖ的人。	
Constance	
Cora	希D女；少女。	
Coral	希D，法珊瑚或品，彩石。	
Cora	
Cornelia	希D山茱萸洌角。	
Corrine	
Cosmo	
Crystal	希D晶的冰，透明的`魂，]有欺m。	
Crystal	(同Krystal)	
Cynthia	希D月亮女神黛安娜的Q。	
Daisy	英r菊。	
Daisy	
Dale	英居住在丘陵g之山谷中者。	
Dana	希伯碜缘的人；神的母H；明且的。	
Daniel	
Daphne	希D神月桂洌还鸸凇	
Daphne	
Darcy	
Darlene	英厝峥郏惑wN地	
Darwin	
Dave	(David的昵称)	
David	
Dawn	英黎明，拘眩振作。	
Debbie	(Deborah,Debra的昵称)	
Debby	希伯砻鄯洌环渫酢	
Deborah	希伯砻鄯洌环渫酢	
Deborah	
Debra	
Deirdre	wn愁的。	
Delia	希D牧羊女	
Demi	
Denise	希D代表花。	
Dennis	
Denny	
Derek	
Diana	拉丁光亮如白；月亮女神	
Diana	
Dick	
Dinah	希伯肀辉u判的人，雅各的女骸	
Dolores	拉丁悲，痛苦或z憾。	
Dolores	
Dominic	拉丁凫渡系鄣摹	
Donald	
Donna	拉丁FD，淑女，夫人。	
Donna	
Dora	希D神的Y。	
Dora	
Doreen	希D神的Y。	
Doris	希D碜源蠛５模缓Ｑ笈神。	
Doris	
Dorothy	希D上帝的Y。	
Douglas	
Duke	
Dylan	
Eartha	英土地或泥土；比喻像大地般匀痰娜恕	
Eddie	
Eden	希伯砺}中的@，g分地。	
Edgar	
Edison	
Edith	古英格Y；。	
Editha	
Edith	
Edmund	
Edward	
Edwina	英有r值的朋友；a的@得者。	
Edwin	
Eileen	w光亮的，人喜g的。	
Elaine	法光亮的；年幼的小鹿。	
Elaine	
Eleanore	法光亮的；多a的，肥沃的，有收的。	
Eleanor	
Elijah	
Elizabeth	希伯砩系鄣氖募s。	
Elizabeth	
Ella	lD火炬	
Ella	
Ellen	希D、拉丁火把	
Ellen	
Ellie	(Eleanor,Ellen的昵称)	
Elliott	
Elma	希D富坌牡娜耍H切的。	
Elsa	希D#092;的。	
Elsa	(Elizabeth的昵称)	
Elsie	希伯恚希D上帝的誓s，#092;的。	
Elva	斯堪的那S神奇且聪明的。	
Elvira	拉丁小精`，白N人的。	
Elvis	
Emerald	
Emily	lD，拉丁勤勉^l的；有一口亮A的嗓音之人；拍R屁的人。	
Emily	
Emma	lD祖先。	
Emma	
Enid	塞特人得毫o瑕恪	
Enid	
Enterprise	
Erica	lD有嗔Φ模坏弁醯模唤y治者。	
Erica	(Eric的女性形式)	
Eric	(Frederick的昵称)	
Erin	w在海中是的翡翠；和平，安之源。	
Estelle	
Esther	希伯硇切	
Esther	
Ethan	
Ethel	英尊F的；出身高F的。	
Eudora	希D可鄣馁Y，美好的、愉快的。	
Eudora	
Eugene	
Eunice	希D快返倮。	
Evangeline	希D福音的信差，福音；天使	
Evan	
Eva	
Eve	希伯砩命；x予生命者生`之母	
Evelyn	塞特生命；易相的人；令人愉快的人。	
Evelyn	
Eve	
Faithe	拉丁忠可信的人。	
Fannie	(同Frances,Fanny)	
Fanny	法自由之人。	
Fay	法忠或忠#092;；小仙女。	
Fay	
Fiona	
Flora	拉丁花；花之神	
Flora	
Florence	塞特_花的或美的。	
Florence	
Flta	
Ford	
Frances	法自由之人，o拘束的人。	
Frances	(Francis的女性形式)	
Francis	
Franklin	
Frank	(Francis,Franklin的昵称)	
Freda	德和平；Iд摺	
Frederica	lD和平的Iд摺	
Frederica	
Fred	
Frieda	
Gabrielle	希伯砩系劬褪橇α俊	
Gabriel	
Gaby	(Gabriel的昵称)	
Gail	w英快返模怀歌；{谷	
Garfield	
Gary	
Gavin	
Gemma	x大利石	
Genevieve	古威斯金碧眼的人；白N人。	
Geoffrey	
George	
Georgia	希Dr夫。	
Geraldine	德而有力的L矛。	
Gill	拉丁少女。	
Gillian	(Juliana的异体)	
Gina	(Angelina,Regina的昵称)	
Gino	
Giselle	lD一把	
Gladys	威斯公主。	
Gladys	(Claudia的威尔斯形式)	
Glendon	
Glen	
Gloria	拉丁s耀者，光s者。	
Gloria	
Grace	英，法，拉丁雅的。	
Grace	
Greta	(Margaret的昵称)	
Griselda	德指φ煞O暮腿棠偷呐人。	
Gustave	德，瑞典。	
Gwendolyn	塞特白色眉毛的。	
Gwendolyn	
Haley	
Hank	
Hannah	希伯雅的。	
Hannah	
Hardy	
Harriet	法家庭主D	
Harrison	
Harry	
Hayden	
Hazel	英I袖，指]官。	
Heather	英_花的石楠。	
Hebe	
Hedda	德Y或痿Y。	
Hedy	希D甜蜜，又令人欣p的。	
Heidi	(Adalheid,Adelaide的昵称)	
Helen	希D，拉丁火把；光亮的。	
Helena	
Hellen	(亦作:Helen)	
Heloise	法健全的；在錾虾艹雒。	
Henna	
Henry	
Hermosa	西班牙美。	
Hilary	拉丁快返摹	
Hilda	lD痿Y；女鹗	
Hillary	
Hilton	
Honey	英H鄣娜恕	
Howard	
Hugo	
Hulda	lD雅，被大深深喜鄣摹	
Hunk	
Ian	
Ida	德快返模勤^的，富有的	
Ignativs	(其变形为Ignace伊格纳茨,Ignatz伊格纳兹)	
Ina	拉丁母H。	
Ingrid	斯堪的那S女海豢鄣娜恕	
Ingrid	
Irene	法，拉丁和平；和平女神。	
Irene	
Iris	拉丁彩虹女神；S尾花。	
Iris	
Irma	拉丁，lD地位很高的；高F的	
Isaac	
Isabel	希伯砩系鄣氖募s。	
Isabella	
Isaiah	
Ishara	
Ivan	
Ivy	希D希D髡f中的神}食物。	
Ivy	
Jackson	
Jack	
Jacob	
Jacqueline	法上帝保o。	
Jacqueline	
Jade	
James	(Jacob的英文形式)	
Jamie	拉丁取而代之者。	
Jamie	(James的女性形式)	
Jane	希伯恚法上帝是慈悲的；少女。	
Janet	希伯恚法少女，上帝的恩n	
Janet	(同Jane)	
Jane	(John的女性名词)	
Janice	希伯恚法少女；上帝是仁慈的。	
Jasmine	
Jason	
Jay	
Jean	法上帝是慈悲的。	
Jean	(Jane的苏格兰形式)	
Jeffery	
Jenna	
Jennifer	英白色的波；施魔法，妖G，迷人的女人。	
Jennifer	
Jenny	希伯恚法少女。	
Jenny	(同Jennie;Jane,Jennifer的昵称)	
Jerome	
Jerry	(Gerald,Jeremiah,Jerome的昵称)	
Jesse	
Jessica	希伯砩系鄣亩；富。	
Jessica	(Jessee的女子形式)	
Jessie	希伯砩系鄣亩；富。	
Jessie	(Jasmine,Jessica的昵称;Janet的苏格兰形式)	
Jill	
Jill	(Gillian的昵称)	
Jimmy	(James的昵称)	
Jim	(James的昵称)	
Jo	
Joa	法，神上帝仁慈的Y。	
Joanna	希伯砩系廴蚀鹊馁Y。	
Joanna	
Joanne	希伯硐２砩系廴蚀鹊馁Y。	
Joan	(同Jane;John的女性形式)	
Jocelyn	拉丁愉快的；快返	
Jocelyn	
Jodie	希伯矸浅Ｎ撵o；美。	
Joe	(Joseph的昵称)	
Johnny	(亦译为:乔尼)	
John	
Joliet	
Jonathan	
Jordan	
Jose/Joseph	
Josephine	希伯碓；多a的女子。	
Josephine	
Joshua	
Josie	(同Josephine)	
Joy	拉丁欣喜；快	
Joyce	拉丁快返模g返摹	
Joyce	(Josephine的昵称)	
Joy	
Judith	希伯碜美；文o之女	
Judith	
Judy	希伯碜美。	
Judy	(Judith的昵称)	
Julia	拉丁^柔的；年p。	
Juliana	
Julia	
Julie	希D有柔和平o的。	
Juliet	拉丁^柔的；年p的。	
Julie	
June	拉丁六月。	
June	
Justin	
Kama	
Karen	希D。	
Karen	(Katherine的丹麦形式)	
Karida	
Kate	(Katherine的昵称)	
Katherine	希D的。	
Katherine	(同Catherine)	
Kathy	(Katherine,Katherleen的昵称;同Cathy,Kathie)	
Katie/Kate/Katy	
Katrina	
Kay	英欣喜的；瑟王之兄弟。	
Kayla	
Kay	(Katherine的昵称;同Kaye)	
Keith	
Kelly	w女鹗俊	
Kelly	
Kelsey	
Kennedy	
Kenneth	
Kenny	(Kenneth的昵称)	
Ken	(Ken结尾名字的昵称)	
Kevin	
Kimberley	英出生皇家草地上的人。	
Kimberly	
Kitty	希D的。	
Kitty	(Catherine的昵称)	
Kristin	希D基督的追S者、T徒。	
Kyle	
Lance	
Lareina	
Larry	(Lawrence的昵称)	
Lassie	
Laura	拉丁月桂洌倮。	
Laura	(Lawrence的女性形式)	
Laurel	拉丁月桂洌倮。	
Lauren	拉丁月桂洹	
Laurent	
Lauren	
Lawrence	
Leander	
Lee	英草地的居民；庇o所。	
Lee	
Leila	阿拉伯黑的美女子；夜晚出生的。	
Lena	拉丁寄宿；寓所。	
Lena	(Helena的昵称)	
Leona	拉丁{。	
Leonard	
Leopold	
Leo	(Leander,Leonard,Leopold的昵称)	
Lesley	w碜岳系谋荆欢青@。	
Leslie	
Letitia	拉丁，西班牙快返模恍老驳摹	
Lilith	希伯凫锻砩系摹	
Lillian	希D一朵百合花，代表；上帝的誓s。	
Lillian	(亦作lilian)	
Lily	
Linda	西班牙美的人。	
Linda	
Lindsay	lD碜院＿的菩提洹	
lindsay	
Lisa	希伯ι穹瞰I。	
Lisa	(Elizabeth的别名)	
Liz	希伯砩系劬褪鞘募s。	
Liz	(Elizabeth的昵称)	
Lora/Laura	
Loren	(同Lauren)	
Lorin	
Lori	(同Lorry)	
Lorraine	法碜苑洛林小的人。	
Lorraine	
Louisa	
Louise	lD闻名的鹗	
Louise	
Louis	
Lucia	
Lucine	
Lucy	拉丁砉饷骱痛厦鞯娜恕	
Lucy	
Luke	
Lulu	(Louise,Louisa的昵称)	
Lydia	英碜岳锏的人，富。	
Lydia	
Lydia	
Lynn	英傍湖而居的人	
Lynn	
Mabel	
Madeline	
Maggie	(Margaret的昵称)	
Mamie	(Margaret,Mary的昵称)	
Manda	
Mandy	(Amanda,Manda,Melinda的昵称)	
Marcus	
Marcy	
Margaret	
Mariah	(同Mary)	
Marilyn	
Marks	
Mark	
Marshal	
Mars	
Martha	
Martin	
Marvin	
Mary	
Mason	
Matilda	
Matthew	
Maureen	
Mavis	
Maxine	
Max	
Mayme	
May	
Megan	
Melinda	
Melissa	
Melody	
Mercedes	
Meredith	
Mia	
Michael	
Michelle	(Michael的女性形式)	
Mickey	
Mike	
Milly	(Camille,Emily,Melissa的简称)	
Miranda	
Miriam	
Miya	
Molly	
Monica	
Morgan	
Nancy	(Nan的别名)	
Natalie	
Natasha	(亦作natascha))	
Nathaniel	
Nathan	
Neil	
Nelson	
Nicholas	
Nick	
Nicole	
Nikita	
Nina	(Anna的昵称)	
Noah	
Nora	
Norman	
Norma	
Nydia	
Octavia	
Olina	
Oliver	
Olivia	
Ophelia	
Oprah	(同Opera,Opie)	
Oscar	
Owen	
Pamela	
Patricia	
Patrick	
Patty	(Mathilda,Matilda,Martha的昵称)	
Paula	
Pauline	(同Paula)	
Paul	
Pearl	
Peggy	(Margaret的昵称)	
Peter	
Philip	
Philomena	
Phoebe	
Phyllis	
Polly	
Priscilla	
Quentina	(Quentin的女性形式)	
Quentin	
Rachel	
Randall	(同Randal)	
Randolph	
Randy	(Randall,Randolph的昵称)	
Raymond	
Ray	
Rebecca	
Reed	
Regina	
Rex	
Richard	
Richie	(同Rick,Ricky,Ritchie.)	
Riley	
Rita	(Margaret的昵称)	
Robert	
Robinson	
Robin	(Robert,Robinson的昵称)	
Rock	
Roger	
Ronald	
Ronald	
Rose	
Rowan	
Roxanne	
Roy	
Ruth	
Ryan	
Sabrina	
Sally	
Samantha	
Sami	
Sammy	(Samson,Samuel的昵称)	
Samuel	
Sam	(Samson,Samuel的昵称)	
Sandra	
Sandra	(Alexandra的昵称)	
Sandy	(Andra的昵称)	
Sarah/Sara	
Savannah	
Scarlett	
Scott	
Sean	(John的爱尔兰形式)	
Selina	
Selma	
Serena	
Sharon	(同Sarah)	
Shawn	(同Sean)	
Sheila	
Shelley/Shelly	(同Sheila,Shelby,Shirley)	
Sherry	(同Charlotte,Cher,Sarah,Shirley)	
Shirley	
Sidney	
Sierra	
Silvia	
Simon	
Solomon	
Sonia	
Sophia	
Spark	
Spencer	
Spike	
Stacy	(Anastasia的昵称)	
Stanley	
Stella	(Estelle的昵称)	
Stephanie	
Steven	(同Stephen)	
Steve	
Stewart	
Stuart	
Sue	(Susan的昵称)	
Sunny	(Sonia的昵称)	
Susan	
Tamara	
Tammy	(Tamara的昵称)	
Tanya/	(Tatiana的昵称)	
Tasha	
Ted	
Terence	
Teresa	
Terry	(Terence的昵称)	
Tess	(Tessa,Teresa的昵称)	
Thomas	
Tiffany	
Timothy	
Tim	
Tina	
Todd	
Tommy	(Thomas的昵称)	
Tom	(Thomas的昵称)	
Tonya	
Tony	(Anthony的昵称)	
Tracy	
Tyler	
Ultraman	
Ulysses	
Ursula	
Vanessa	
Van	
Venus	
Vera	
Vernon	
Vern	(Vernon的昵称)	
Vicky	(Victoria的昵称)	
Victoria	
Victor	
Vincent	
Violet	
Virginia	
Vita	
Vivian	
Wanda	
Warner	
Warren	
Wayne	
Wendy	(Gwendolyn,Wanda的昵称)	
Wesley	
Whitney	
William	
Willy	
Winnie	
Wynne	
Yolanda	
Yvette	(同Yvonne)	
Yvonne	
Zachary	
Zack	
Zara	
Zelda	
Zoey/Zoe	
Zora	
